1111111111111111111111111111111111111111111111111111111111111111111111111111111111111111111111111111
3000000000000000000000111100000000000000000000000000000000000000000000000000000000000000000000000001
1011111111111111011111111111111111111111111111111111111111111111111011111111101111111111111011111111
1011111111111111011111111111111111000000000000000111000000000000111011111111101111111111111011111111
1011111111111111011111111111111111011111111111110111011111111110111011111111101111111111111211111111
1011111111111111011111111111111111011111111111110111011111111110111011111111101111111111111011111111
1011111111111111011111111111111111011111111111110111011111111110111011111111101111111111111011111111
1011111111111111011111111111111111011111111111110111011111111111000000000000001111111111111011111111
1011111111111111011111111111111111011111111111110111000000000000111111110111111111111111111011111111
1011111111111111011111111111111111011111111111110111011111111110111111110111111111111111111011111111
1011111111111111011111111111111111011111111111110000011111111110111111110111111111111111111011111111
1011111111111111011111111111111111011111111111111111011111111110111111110111111111111111111111111111
1011111111111111000000000000000000000110000000000111011111111110111111110111111111111111111011111111
1011111111111111111111111111111111111111111110111111111111111110111111110111111111111111111011111101
1000200000000000000000000000000000000000001110000000000000000000000000000000000000000000001111111101
1011111111111111111111111111111111111111111111111111111111111111111111101111111111111011111111111101
1000000000000000000000000000000000000000000000000000000000000000000000001111111111111011111111111101
1011111111111111111111111111111111111111111111111111111111111111111111101111111111111011111111111101
1000000000000000000000000011111110000000111111111111111100000000000000001111111111111011111111111101
1011111111111111111111011111111110111110111111111000000001111111111111101111111111111011111111111101
1000000000000000000000011111111111111110111111111111111100000111111111101111111111111011111111111101
1011111111111111111111011111111111111110111111111111111111111111111111101111111111111011111000000001
1000000000000000000000000000000000000000000000000000000000000000000000001110001111111011111011111101
1011111111111111111111111111111111111110111111111111111111111111011111101110101111111011111011111101
1011111111111111111111111111111111111110111111111111111111111111011111101110101111111011111011111101
1011111111111111111111111111100000000000111111111111111100000111011111101110101111111011111011111101
1011111111111211111111111111101111111110111111111111111101111111011111101110101111111011111011111101
1000000000000000000000000000001111111110000000000000000201111111011111100000100000000000000010000001
1011111111111011111111111111111111111111111111111111111101111111000011111111111111111111111111111102
1111111111111111111111111111111111111111111111111111111111111111111111111111111111111111111111111111